1111111111111111
1000000000100001
10000000001C1001
1P00011100111001
100001C100000001
10000001000000E1
1111111111111111
